NO imgs/64x64xpm/CSTX0544.xpm
SO imgs/64x64xpm/CSTX2054.xpm
WE imgs/64x64xpm/CSTX1906.xpm
EA imgs/64x64xpm/CSTX1905.xpm
F 0,0,0
C 252,3,136



1111111       11111111111111111111111111111111111111111111
1111111       10000000000000000000000000000000000000010001
11000111111111100000000N0000000000000000000000000000010001
11010000000000D0000000000000000000000000000000000000010001
11000111111101110000000000000000000000000000000000000D0001
1000001    101 1000000000000000000000000000000000000010001
1000001    111 1000000000000000000000000000000000000011111
1000001        1000000000000000000000000000000000000000001
1111111        1000000000000000000000000000000000000000001
               1111110000000000000000000000000000000000001
               1000000000000000000000000000000000000000001
               1000000000000000000000000000000000000000001
               1000000000000000000000000000001111D11111111
               1000000100111110110000000000001000000000001
               1000000000000000000000000000001000000000001
               1000000000000000000000000000001000000000001
               1000000000000000000000000000001000000000001
               1000000000000000000000000000001000000000001
               1000000000000000000000000000001000000000001
               1000000000000000000000000000001000000000001
               1000000000000000000000000000001000000000001
               1000000000000000000000000000001000000000001
               1000000000000000000000000000001000000000001
               1000000000000000000000000000001000000000001
               1000000000000000000000000000001000000000001
               1111111111111111111111111111111111111111111
